{
  "tileset": "basic-online.png",
  "terrain": [
    [1,1,1,1,1,1,1,1],
    [1,4,5,3,5,4,1,1],
    [1,4,4,4,4,1,1,1],
    [1,1,1,7,5,5,1,1],
    [1,1,1,4,4,4,1,1],
    [1,1,1,1,1,1,1,1]
  ],
  "chemin": [
    [0,0,0,0,0,0,0,0],
    [0,1,1,0,1,1,0,0],
    [0,1,1,1,1,0,0,0],
    [0,0,0,0,1,1,0,0],
    [0,0,0,1,1,1,0,0],
    [0,0,0,0,0,0,0,0]
  ]
}
